20 20

0	0	0	0	0	0	0	0	0	0	0	1	0	0	0	1	0	0	0	0

0	0	0	0	0	0	0	0	0	0	0	1	0	0	0	1	0	0	0	0

0	0	0	0	0	0	0	0	0	0	0	1	0	0	0	1	0	0	0	0

0	0	0	0	0	0	0	0	0	0	0	1	0	0	0	1	0	0	0	0

0	0	0	0	0	0	0	0	0	0	0	1	0	0	0	1	0	0	0	0

0	0	0	0	0	0	0	0	0	0	0	1	0	0	0	1	0	0	0	0

0	0	0	0	0	0	0	0	0	0	0	1	0	0	0	1	0	0	0	0

0	0	0	0	0	0	0	0	0	0	0	1	0	0	0	1	0	0	0	0

0	0	0	0	0	0	0	0	0	0	0	1	0	0	0	1	0	0	0	0

0	0	0	0	0	0	0	1	1	1	1	1	0	0	0	1	1	1	1	0

0	0	0	0	0	0	0	1	0	0	2	0	0	0	0	0	0	0	1	0

0	0	0	0	0	0	0	1	0	0	0	0	0	0	0	0	0	0	1	0

1	1	1	1	1	1	1	1	0	0	0	0	0	0	0	0	0	0	1	0

0	0	0	0	0	0	0	0	0	0	0	0	0	0	0	0	0	0	1	0

0	0	0	0	0	0	0	0	0	0	0	0	0	14	0	0	0	0	1	0

1	1	1	1	1	1	1	1	0	0	0	0	0	0	0	0	0	0	1	0

0	0	0	0	0	0	0	1	0	0	0	0	0	0	0	0	0	0	1	0

0	0	0	0	0	0	0	1	0	0	0	0	0	0	0	0	0	0	1	0

0	0	0	0	0	0	0	1	0	0	0	0	0	0	0	0	0	0	1	0

0	0	0	0	0	0	0	1	0	0	0	0	0	0	0	0	0	0	1	0

Map09.txt